// Deus Vult II
generator Lexicon_DSV2_Pistol	BulletChip
generator Lexicon_DSV2_Chainsaw	BulletChip
generator Lexicon_DSV2_Shotgun	BulletChip
generator Lexicon_DSV2_Chaingun	BulletChip

generator Lexicon_DSV2_ZombieMan	BulletChip
generator Lexicon_DSV2_ShotgunGuy	BulletChip
generator Lexicon_DSV2_ChaingunGuy	BulletChip
generator Lexicon_DSV2_SpiderMastermind	BulletChip

// Drown in Blood
generator Lexicon_DIBL_Pistol	BulletChip
generator Lexicon_DIBL_Shotgun	BulletChip
generator Lexicon_DIBL_Chaingun	BulletChip
generator Lexicon_DIBL_Rocket	Scorch

generator Lexicon_DIBL_ZombieMan	BulletChip
generator Lexicon_DIBL_ShotgunGuy	BulletChip
generator Lexicon_DIBL_ChaingunGuy	BulletChip
generator Lexicon_DIBL_SpiderMastermind	BulletChip

// Haste
generator Lexicon_HSTE_ArachnotronPlasma	ArachnotronScorch
generator Lexicon_HSTE_PlasmaBall	PlasmaScorch

// Slaughterfest 3
generator Lexicon_SF13_Arachnotron	ArachnotronScorch
generator Lexicon_SF13_PlasmaBall	PlasmaScorch
